Account number,Date,Memo/Description,Source Code (payment type),TP ref,TP part,TP code,OP ref,OP part,OP code,OP name,OP Bank Account Number,Amount (credit),Amount (debit),Amount,Balance
01-2345-6789012-34,01-10-1982,Dent A salary BBC Radio,AP,Salary,BBC Radio,,,,,BBC Radio,01-0101-0101010-10,154.30,,154.30,179.92
01-2345-6789012-34,04-10-1982,To emergency,,Emergency,,,,,,,01-2345-6789012-35,,10.00,-10.00,169.92
01-2345-6789012-34,05-10-1982,Holiday,,Holiday,,,,,,,12-3456-7890123-45,,25.00,-25.00,144.92
01-2345-6789012-34,04-10-1982,155 Country Lane rates CCC,DD,Rates,CCC,,,,,CCC,98-7654-3210987-65,,10.37,-10.37,134.55
01-2345-6789012-34,07-10-1982,Horse and Groom,,,,,,,,,,,4.38,-4.38,130.17
01-2345-6789012-34,07-10-1982,From emergency,,Emergency,,,,,,,01-2345-6789012-35,42.42,,42.42,172.59
